a: to, at;
abajo: down, downstairs, below;
el abanico: fan (to move air);
abierto: open;
abrazar: to embrace;
el abrazo: embrace, hug;
el abrigo: overcoat;
abrir: to open;
acá: here;
acabar: to finish;
la acción: action;
aceptar: to accept;
acerca de: about;
acercarse: to approach;
acompañar: to accompany, go with;
aconsejar: to advise;
acordarse: to remember;
acostarse: to go to bed;
actual: present, current;
el acuerdo: agreement: ;
adelante: ahead, forward;
además: moreover, besides;
adentro: inside;
adiós: goodbye;
adónde: where;
la aduana: customs house;
el aeropuerto: airport;
afeitarse: to shave;
afuera: outside;
el agente: agent;
agradable: pleasant;
agradecer: to thank;
el agua: water;
aguantar: to stand;
la aguja: needle;
ahora: now;
el aire: airport;
al + infinitive: on, upon;
el alcalde: mayor;
la alcoba: bedroom ;
arriba: up, above;
arrojar: to throw;
el/la arte: art;
el artículo: article;
el/la artista: artist;
asado: roasted;
el ascensor: elevator;
asegurar: to insure;
los aseos: (pl) restroom, toilets;
así: thus, this way;
el asiento: seat;
asistir a: to attend;
el asunto: matter, affair;
atrás: back, behind, backward;
atrasado: slow;
atravesar: to cross;
atreverse: to dare;
aunque: although;
el autobús: bus;
el automóvil: automobile, car ;
la autoridad: authority;
la avenida: avenue;
averiguar: to ascertain, find out;
el avión: airplane;
avisar: to inform, warn;
el aviso: notice, warning;
ayer: yesterday;
ayudar: to help;
el ayuntamiento: city hall, town hall;
bailar: to dance;
el baile: dance;
bajar: to go down, get off;
bajo: low, short (stature);
el banco: bank, bench;
la bandera: flag;
bañarse: to bathe;
el baño: bath, bathroom;
barato: cheap, inexpensive;
la barba: chin, beard;
el barco: boat, ship ;
el barrio: district, neighborhood;
bastante: enough, sufficient;
bastar: to suffice, be enough;
el baúl: trunk;
beber: to drink;
la bebida: drink, beverage;
bello: beautiful;
besar: to kiss;
el beso: kiss;
la biblioteca: library;
bien: well;
bienvenido: welcome;
el billete: ticket, bill (bank note);
la blusa: blouse;
la boca: mouth;
la boda: wedding;
el boleto: ticket;
la bolsa: bag, purse;
el bosillo: pocket;
bonito: pretty ;
borracho: drunk; drunkard;
el bosque: forest, woods;
botar: to throw out, discard;
la botella: bottle;
el brazo: arm;
breve: brief;
la broma: joke, jest;
buen, bueno: good, all right;
el bulto: package, bundle;
el buque: ship, boat;
buscar: to look for;
el caballero: gentleman, sir;
caber: to fit in, to be room for;
la cabeza: head;
cada: each;
caer: to fall;
la cafetería: bar with food service;
la caja: box, cash register;
cajero(a): cashier;
el calcetín: sock ;
la calentura: fever;
caliente: warm, hot;
el calor: heat, warmth;
la calle: street;
la cama: bed;
la cámera: camera;
la camarera: chambermaid, waitress;
el camarero: waiter;
cambiar: to change, exchange;
el cambio: change exchange;
caminar: to walk;
el camino: road;
el camión: truck; bus (mexico);
la camisa: shirt;
la camiseta: T-shirt, undershirt;
la campana: bell;
el campo: country, field;
la canción: song;
cansado: tired;
cantar: to sing ;
la capital: capital (city);
el capital: capital (money);
la cara: face;
!caramba!: gosh!;
la cárcel: jail;
el cariño: affection, love;
cariñoso: affectionate;
caro: expensive;
el carro: car;
la carta: letter, playing card;
la cartera: wallet, purse;
la carretera: highway;
la casa: house, home;
casado: married;
casarse: to get married;
casi: almost;
el caso: case, matter, thing;
el castillo: castle;
la casualidad: chance, coincidence;
el catarro: cold (respiratory) ;
la catedral: cathedral;
la cena: supper, dinner;
cenar: to eat supper (dinner);
el centro: center, business district;
el cepillo: brush;
cerca de: near;
cerrado: closed;
cerrar: to close;
la cesta: basket;
ciego: blind;
el cielo: sky, heaven;
cierto: certain, sure, true;
el cine: movie theater, movies;
la cinta: tape;
el cinturón: belt;
la cita: appointment, date;
la ciudad: city, town;
claro: clear, light (color) of course;
la clase: class, kind, type;
el/la cliente: client, customer ;
el clima: climate;
cobrar: to collect, charge, cash;
la cocina: kitchen;
cocinar: to cook;
cocinero(a): cook;
el coche: car, coach;
coger: to take, catch;
la cola: line (queue), tail;
el collar: necklace;
la comedia: play, comedy;
el comedor: dining room;
comenzar: to begin;
comer: to eat supper (dinner);
los comestibles: foods, groceries;
la comida: food, meal;
como: as, like;
cómodo: comfortable;
compañero(a): companion, friend;
la compaña: company;
comprar: to buy ;
comprender: to understand;
el compromiso: engagement;
con: with;
conducir: to drive, conduct;
la conferencia: conference, lecture;
confuso: confused;
conmigo: with me;
conocer: to know, to meet;
conseguir: to get, obtain;
el consulado: consulate;
contar: to count, tell;
contento: content, glad;
contestar: to answer, reply;
continuar: to continue, go on;
contra: against;
contrario: contrary;
la copa: (wine) glass, drink;
el corazón: heart;
la corbata: tie;
correcto: correct ;
el correo: mail, post office;
corregir: to correct;
correr: to run;
la corrida (de toros): bullfight;
cortar: to cut;
cortés: polite;
corto: short;
la cosa: thing;
coser: to sew;
la costa: coast;
costar: to cost;
la costumbre: custome;
creer: to believe, think;
criado(a): servant;
el crimen: crime;
crudo: raw;
la cruz: cross;
cruzar: to cross;
el cuaderno: notebook;
la cuadra: (city) block ;
el cuadro: picture;
?cuál?: which, which one?;
cuando: when;
?cuánto?: how much;
el cuarto: room, quarter, fourth;
cubrir: to cover;
la cuchara: tablespoon;
la cucharita: teaspoon;
el cuchillo: knife;
el cuello: neck, collar;
la cuenta: check, bill (restaurant);
el cuento: story, tale;
el cuero: leather;
el cuerpo: body;
el cuidado: care;
cuidarse: to take care (of oneself);
el cumpleaños: birthday;
cumplir: to complete, fulfill;
el cura: priest;
el curso: course, class ;
la chaqueta: jacket;
el cheque: check, bill (restaurant);
chico(a): boy, girl, kid;
el chiste: joke, jest;
chocar: to collide, crash, shock;
el chófer: driver;
la dama: lady;
el daño: harm, damage;
dar: to give;
de: of from;
debajo (de): below, underneath;
deber: should, ought to, to owe;
débil: weak;
decidir: to decide;
decir: to say, tell;
el dedo: finger;
dejar: to let, permit, allow, leave;
delante de: in front of;
delgado: slim, thing;
demás: (the) rest ;
demasiado: too, too much;
dentro: inside, within;
depender: to depend;
dependiente (el/la): salesclerk;
el deporte: sport;
derecho: right, straight;
desarrollar: to develop;
desayunar(se): to eat breakfast;
el desayuno: breakfast;
descansar: to rest;
descubrir: to discover;
el descuento: discount;
desde: since;
desear: to desire, wish;
la desgracia: misfortune;
desmayarse: to faint;
despacio: slowly;
desedirse: to say goodbye;
despertar(se): to awaken, wake up;
después (de): after ;
el destino: destination, destiny;
detrás (de): behind, in back of;
devolver: to return, give back;
el día: day;
el dibujo: drawing, sketch;
el diente: tooth;
difícil: difficult, hard;
el dinero: money;
el Dios: God;
la dirección: direction, address;
la distancia: distance;
divertirse: to have a good time, to enjoy oneself;
doblar: to turn, fold;
la docena: dozen;
el dólar: dollar;
doler: to hurt, ache;
el dolor: pain, ache;
donde: where;
?dónde?: where?;
dormir: to sleep ;
la ducha: shower;
dudar: to doubt;
dueño(a): owner;
dulce: sweet;
durante: during;
durar: to last;
duro: hard, difficult;
echar: to throw, pour;
la edad: age;
el edificio: building;
el efectivo: cash;
el efecto: effect;
el ejemplo: example;
el ejército: army;
ellos: they;
él: him;
ella: her;
la embajada: embassy;
sin embargo: nevertheless;
empezar: to begin ;
empleado(a): employee;
el empleo: employment, job;
empujar: to push;
en: in, on, at;
enamorado: in love;
encantado: delighted, charmed, pleased to meet you;
encender: to light, turn on;
encima de: above, on top of;
encontrar: to find, meet;
enfermo: sick, ill;
enfrente: front, opposite, facing;
engañar: to deceive;
enojar: to annoy;
enseñar: to teach, show;
entender: to understand;
entonces: then, at that time;
la entrada: entrance, admission;
entrar: to enter, come in;
entre: between, among;
entregar: to deliver, hand over ;
el entremés: appetizer, intermission;
enviar: to send;
envolver: to wrap;
el equipaje: luggage, baggage;
el equipo: team;
equivocarse: to be mistaken, to be wrong;
la escalera: staircase, stairs;
escoger: to choose, select;
esconder: to hide;
escribir: to write;
eschuchar: to listen;
la escuela: school;
el ese: that, those;
el esfuerzo: effort;
el espacio: space;
la espalda: back, shoulder;
la España: Spain;
el español: spanish;
el espectáculo: spectacle, show;
el espejo: mirror ;
esperar: to hope, wait (for);
la esquina: (street) corner;
la estación: station, season;
estacionar: to park;
el estado: state, condition;
los Estados Unidos: United States;
estar: to be;
la estatua: statue;
el este: east;
este: this, thes (estos);
el estómago: stomach;
estrecho: narrow, tight;
la estrella: star;
estudiante (el/la): student;
estudiar: to study;
estupendo: stupendous, wonderful;
la Europa: Europe;
el examen: exam;
exigir: to demand, require;
el éxito: success ;
explicar: to explain;
el extranjero: foreigner, stranger, foreign;
extrañar: (Spanish America) to miss;
extraño: strange;
la fábrica: factory;
fácil: easy;
la falda: skirt;
la falta: mistake, lack;
la familia: family;
famoso: famous;
la fe: faith;
la fecha: date (in time);
las felicitaciones: congratulations;
feliz: happy;
feo: ugly;
el ferrocarril: railroad;
fiar: to trust;
la fiebre: fever;
la fiesta: holiday, party;
el fin: end ;
firmar: to sign;
flamenco: flamenco, Gypsy dancing and music;
la flor: flower;
el fósforo: match;
la foto(grafía): photo;
frascar: to fail;
francés: French;
la Francia: France;
la frase: sentence, phrase;
la frazada: (Spanish America) blanket;
el frente: front;
la frente: forehead;
frío: cold;
frito: fried;
la frontera: border;
el fuego: fire;
fuera (de): outside;
fuerte: strong;
fumar: to smoke;
la función: function, show, performance ;
funcionar: to function, work;
el fútbol: soccer;
las gafas: eyeglasses;
la gana: desire;
ganar: to earn, win;
la ganga: bargain;
la garganta: throat;
gastar: to spend;
la gente: people;
el gerente: manager;
el gobierno: government;
el golpe: blow, knock;
gordo: fat;
la gota: drop;
gozar (de): to enjoy;
gracias: thanks;
gran, grande: big, large, great;
gritar: to shout;
el grito: shout;
el grupo: group ;
el guante: glove;
guapo: handsome;
guardia (el/la): guard, police officer;
la guerra: war;
guía (el/la): guidebook;
gustar: to please, like;
el gusto: pleasure;
la habitación: room;
hablar: to speak, talk;
hacer: to do, make;
hacia: toward;
hallar: to find;
la hambre: hunger;
hasta: until;
hay: there is, there are;
hermoso: beautiful;
el hielo: ice;
hola: hi, hello;
el hombre: man;
la hora: hour, time ;
el horario: schedule, timetable;
hoy: today;
la huelga: strike;
huésped (el/la): guest;
el humo: smoke;
la ida: going, leaving;
el idioma: language;
la iglesia: church;
igual: equal, same;
igualmente: likewise;
el impermeable: raincoat;
importar: to import, to matter;
el impuesto: tax;
el incendio: fire;
indicar: to indicate, show;
el ingeniero: engineer;
la Inglaterra: England;
el inglés: English;
inmediatamente: immediately;
el entrés: interest ;
inútil: useless;
ir: to go;
izquierda: left;
el jabón: soap;
jamás: never, ever;
el jardín: garden;
el jefe: boss, chief, head;
joven: young;
la joya: jewel;
judío(a): Jew;
el juego: game;
juez (el/la): judge;
jugar: to play;
el juguete: toy;
juntos: together;
jurar: to swear;
el kilo(gram): kilogram;
el kilómetro: kilometer;
la: the, her, it;
las: the, them ;
el labio: lip;
el lado: side;
el ladrón: thief;
el lago: lake;
la lámpara: lamp;
la lana: wool;
el lápiz: pencil;
largo: long;
la lástima: pity;
la lavabo: sink, lavatory;
lavar(se): to wash (oneself);
le: to him, to her, to you;
la lección: lesson;
leer: to read;
lejos: far (away);
la lengua: language, tongue;
lentamente: slowly;
los lentes: eyeglasses;
la letra: letter;
el letrero: sign ;
levantar: to live, raise;
levantarse: to get up, stand up;
la ley: law;
libre: free;
el libro: book;
ligero: light (weight);
el límite: limit, boundary;
limpiar: to clean;
limpio: clean;
lindo: pretty;
la línea: line;
la lista: list, menu;
listo: ready, smart, bright;
el litro: liter;
lo: it, him, you;
loco: mad, insane, crazy;
los: the them you;
la lucha: struggle, fight;
luego: then, after;
el lugar: place ;
el lujo: luxury;
la luna: moon;
la luz: light;
la llamada: call;
llamar(se): to call, to be called;
la llave: key;
la llegada: arrival;
llegar: to arrive;
llenar: to fill;
lleno: full;
llevar: to carry, wear, take;
llorar: to cry;
llover: to rain;
la lluvia: rain;
la madera: wood;
maduro: ripe;
maestro(a): teacher;
mal(o): bad, badly, ill;
la maleta: suitcase;
mandar: to send, command ;
la manera: manner, way;
la mano: hand;
la manta: (Spain) blanket;
mantener: to maintain, support;
la mañana: morning, tomorrow;
el mapa: map;
el mar: sea;
más: more;
me: (to me);
la media: stocking;
la medianoche: midnight;
el médico: doctor;
la medida: size, measurement;
medio: half;
el mediodía: noon;
mejor: better, best;
mejorar: to improve, feel better;
menor: smaller, smallest; younger, youngest;
menos: less, least;
la mentira: lie ;
a menudo: often;
el mercado: market;
merecer: to deserve;
la merienda: afternoon or morning snack;
el mes: month;
la mesa: table;
mesero(a): waiter, waitress;
meter: to put (in);
el método: method;
el metro: meter;
mi, mis: my;
el miedo: fear;
el miembro: member;
mientras que: while;
el milagro: miracle;
la mila: mile;
mío: mine;
mirar: to look (at);
mismo: same, oneslelf;
la mitad: half ;
la moda: style, fashion;
el modo: way manner;
mojar: to wet;
molestar: to disturb, bother, molest;
la molestia: bother;
la moneda: coin;
la montaña: mountain;
moreno: brunette, dark-complexioned;
morir: to die;
mostrar: to show;
el mozo: porter, young man;
muchacho(a): boy, girl;
mucho: much;
mudar: to change, move;
los muebles: furniture;
la muerte: death;
muerto: dead;
la muestra: sample;
la mujer: woman, wife;
la multa: fine (fee) ;
el mundo: world;
la muñeca: doll;
el museo: museum;
la música: music;
muy: very;
nacer: to be morn;
nada: nothing;
nadar: to swim;
la Navidad: Christmas;
nadie: no one, nobody;
la nariz: nose;
necesario: necessary;
necesitar: to need;
negar: to deny;
el negociante: businessman;
los negocios: businesses;
nevar: to snow;
ni: neither, nor;
la neibla: fog;
la nieve: snow ;
ningún, ninguno: none;
niño(a): child, boy, girl;
el nivel: level;
no: no, nor;
la noche: night;
el nombre: name;
el norte: north;
nos: (to) us;
nosotros(as): we;
la noticía: news, piece of news;
novio(a): boyfriend, girlfriend, fiancé, fiancée;
la nube: cloud;
nublando: cloudy;
nuestro: our;
nuevo: new;
el número: number;
nunca: never;
o: or, either;
el objecto: object, purpose;
obligar: to oblige, force ;
la obra: work;
obtener: to obtain, get;
el océano: ocean;
ocupado: busy, occupied;
ocurrir: to happen, occur;
odiar: to hate;
el oeste: west;
la oficina: office;
el oído: ear, hearing;
oír: to hear;
!ojalá!: I wish (that)!;
el ojo: eye;
oler: to smell;
el oloer: odor, smell;
olvidar: to forget;
onza: ounce;
la oportunidad: opportunity;
el orden: sequence;
la orden: command, order (business);
el ordenador: computer ;
la oreja: ear;
el oro: gold;
otro: other, another;
pagar: to pay;
la página: page;
el país: country;
el paisaje: landscape;
la palabra: word;
el palacio: palace;
pálido: pale;
los pantalones: pants, trousers;
el pañuelo: handkerchief;
el papel: paper;
el paquete: package;
el par: pair;
para: for, in order to;
la parada: stop;
el paraguas: umbrella;
parar: to stop;
parecer: to seem ;
la pared: wall;
pariente (la/el): relative;
el parque: park;
el párrafo: paragraph;
la parte: part;
el partido: game;
pasado: past, last;
el pasajero: passenger;
pasar: to pass, spend;
el paseo: walk, ride;
el pasillo: aisle, corridor;
el paso: pace, opening;
la pastilla: tablet, lozenge;
el patrón: pedestrian;
el pecado: sin;
el pecho: chest (human body);
el pedazo: piece;
pedir: to ask for, order;
pegar: to hit, paaste;
la película: movie, film ;
el peligro: danger;
peligroso: dangerous;
el pelo: hair;
la pelota: ball;
la pena: ache, grief;
los pendientes: earrings;
pensar: to think, intend;
la pensión: boardinghouse;
peor: worse, worst;
pequeño: small, little;
perder: to lose, miss;
el perdón: pardon (me), forgiveness;
el periódico: newspaper;
permanecer: to remain, stay;
el permiso: permission, pass;
permitir: to permit, allow;
pero: but;
pertenecer: to belong;
pesado: heavy;
pesar: to weigh ;
el peso: weight;
picante: hot, spicy;
pico: peak, a little;
el pie: foot;
la piedra: stone;
la piel: skin;
la pierna: leg;
la píldora: pill;
pintar: to pain;
pintoresco: picturesque;
la pintura: painting;
la piscina: swimming pool;
el piso: floor, apartment;
planchar: to iron;
el plano: map;
la plata: silver, money;
el plátano: banana;
el plato: plate, dish;
la playa: beach;
la plaza: plaza, public quare ;
la pluma: pen, feather;
pobre: poor;
poco: little, small amount;
poder: to be able to, can;
la poesía: poetry;
la policía: police;
policía (la/el): police officer;
poner: to put, place;
por: for, by, in exchange for;
porque: because;
?por qué?: why?;
el portero: doorman, porter;
el precio: price;
la pregunta: question;
preguntar: to ask;
el premio: prize, award;
preocuparse: to worry;
preparar: to prepare;
prestar: to lend;
el presupuesto: budget ;
primer, primero: first;
la prisa: hurry;
probar: to taste, prove;
el problema: problem;
prohibir: to prohibit, forbid;
la promesa: promise;
prometer: to promise;
pronto: soon;
la propiedad: property;
el propietario: owner, proprietor;
la propina: tip;
el propósito: purpose;
proteger: to protect;
el provecho: profit, benefit;
próximo: next;
el proyecto: project;
la prueba: proof, test;
el pueblo: village, town;
el puente: bridge;
la puerta: door ;
el puerto: port, harbor;
el puesto: post, stand, job, position;
la pulsera: bracelet;
el punto: point dot;
que: that, which, who;
?qué?: what?;
quedar: to remain, be left;
la queja: complaint;
quejarse: to complain;
quemar: to burn;
querer: to want, wish, love;
quien: who, whom;
?quién?: who, whom?;
quitar: to take away;
quitarse: to take off (clothing);
quizás: perhaps;
rápido: rapid, quick;
rato: while;
la razón: reason;
tener razón: to be right ;
real: royal;
el recado: message;
la receta: recipe, prescription;
recibir: to receive;
el recibo: receipt;
reconocer: to recognize;
recordar: to remember;
recuerdo: remebrance, regards, souvenir;
rechazar: to reject;
el regalo: gift;
el régimen: rigime, diet;
la regla: rule, regulation;
regresar: to return come back, go back;
regular: regular, OK;
la reina: queen;
reír(se): to laugh;
el reloj: clock, watch;
el remedio: remedy, cure;
el renglón: line;
de repente: suddenly ;
repitir: to repeat;
el resfriado: cold (respiratory);
respirar: to breathe;
responder: to answer, reply;
la respuesta: answer, reply;
el retraso: delay;
el retrato: picture (of people), portrait;
la reunión: meeting, reunion;
revelar: to reveal, develop (film);
la revista: magazine;
el rey: king;
rico: rich, delicious;
el rincón: corner;
el río: river;
robar: to rob, steal;
la rodilla: knee;
romper: to break, tear;
la ropa: clothing, clothes;
roto: broken;
el ruido: noise ;
la ruta: route;
la sábana: (bed)sheet;
saber: to know;
sacar: to take out;
el saco: bag, sack, jacket (Spanish America);
la sala: living room;
la salida: exit;
salir: to leave, go out;
el salón: salon, classroom;
la salud: health;
laudar: to greet;
el saludo: greeting, regards;
la sangre: blood;
satisfecho: satisfied;
se: himself, herself, yourself, themselves, yourselves, oneself, one another;
secar: to dry;
seco: dry;
la sed: thirst;
la seda: silk;
seguir: to follow, continue ;
según: according to;
el segundo: second;
seguro: sure, certain;
el seguro: insurance;
el sello: stamp;
la semana: week;
sencillo: simple, plain;
setarse: to sit down;
sentir: to be sorry;
sentirse: to feel;
la señal: signal;
el señor: gentleman, sir, Mr.;
la señora: lady, madam, Mrs.;
la señorita: young lady, Miss;
separar: to separate;
ser: to be;
serio: serious;
el servicio: service, restroom;
la servilleta: napkin;
servir: to serve ;
si: if, whether;
sí: yes;
siempre: always;
el siglo: century;
significar: to mean;
siguiente: following, next;
la silla: chair;
simpático: nice pleasant, congenial;
sin: without;
el sitio: place, spot;
sobre: over, about, on;
el sol: sun;
el sobre: envelope;
solamente: only;
solo: alone;
sólo: only;
el soltero: bachelor, unmarried;
la sombra: shade, shadow;
el sombrero: hat;
sonreír: to smile ;
su: his, her, your, their;
subir: to go up;
sucio: dirty;
el suelo: floor;
el sueño: sleep, dream;
la suerte: luck;
por supuesto: of course;
el sur: south;
el tabaco: tobacco;
tal: such;
la talla: size;
el tamaño: size;
también: also, too;
tampoco: neither;
las tapas: snacks, appetizers (at a bar);
la taquilla: ticket office, box office;
tarde: late;
la tarde: afternoon;
la tarjeta: card;
la taza: cup ;
el treatro: theater;
el techo: ceiling, roof;
la tela: cloth, material;
el teléfono: telephone;
temprano: early;
el tenedor: fork;
tener: to have;
el tiempo: time, weather;
la tienda: store, shop;
la tierra: land, earth;
las tijeras: scissors;
la tinta: ink;
típico: typical;
tirar: to throw, pull;
la toalla: towel;
tocar: to touch, play (an instrument);
todavía: still, yet;
todo: all, everything;
todos: all, everybody;
tomar: to take, eat, drink ;
la tormenta: storm;
el toro: bull;
la torre: tower;
la tos: cough;
trabajar: to work;
el trabajo: work;
traducir: to translate;
traer: to bring;
el traje: suit, attire;
tranquilo: tranquil, calm, quiet;
tratar: to try;
el tren: train;
triste: sad;
tu: your;
tú: you;
último: last;
usar: to use;
usted: you;
útil: useful;
las vacaciones: vacations ;
vacío: empty;
vale: OK, goodbye;
valer: to be worth, to cost;
el valle: valley;
various: several;
el vaso: glass;
el vecino: neighbor;
la velocidad: speed;
vender: to sell;
venir: to come;
la ventaja: advantage;
la ventana: window;
ver: to see;
de veras: really;
la verdad: truth;
verdadero: true, real;
la vergüenza: shame;
el vestido: dress;
vestirse: to get dressed;
la vez: time (occasion) ;
viajar: to travel;
el viaje: trip;
el viajero: traveler, passenger;
la vida: life;
viejo: old;
el viento: wind;
la vista: sight, view;
vivir: to live;
volar: to fly;
volver: to come back, return;
votar: to vote;
la voz: voice;
el vuelo: flight;
la vuelta: change, turn, stroll;
de vuelta: back;
y: and;
ya: already;
yo: I;
el zapato: shoe;